0 0 0 0 0 0 0 0 0 0 0 0 0 0 0 0 0
0 0 0 0 0 0 0 0 0 0 0 0 0 0 0 0 0
0 0 0 0 0 0 0 0 0 0 0 0 0 0 0 0 0
0 0 0 0 5 3 3 3 3 3 3 3 6 0 0 0 0
0 0 0 0 7 1 2 1 2 1 2 1 8 0 0 0 0
0 0 0 0 7 1 2 1 2 1 2 1 8 0 0 0 0
0 0 0 0 7 1 2 1 2 1 2 1 8 0 0 0 0
0 0 0 0 7 1 2 1 2 1 2 1 8 0 0 0 0
0 0 0 0 7 1 2 1 2 1 2 1 8 0 0 0 0
0 0 0 0 0 0 0 0 9 0 0 0 0 0 0 0 0
0 0 0 0 0 0 0 0 0 0 0 0 0 0 0 0 0
0 0 0 0 0 0 0 0 0 0 0 0 0 0 0 0 0
0 0 0 0 0 0 0 0 0 0 0 0 0 0 0 0 0